###########################################
# ******            #           ********* #
# *#  #*         #*###*#        *#     #* #
# *## #*       #    #    #      * #   # * #
# *# ##*      *     #     *     * # # # * #
# *#  #*     #      #      #    *  ###  * #
# ******     #      @      #    ********* #
#            #    ## ##    #              #
#            *  ##     ##  *              #
#             ##         ##               #
#               *#**#**#*                 #
#   ***********************************   #
###########################################